Sand Dancer
An Interactive Fiction by Matthew Deline
Release 1 / Serial number 180403 / Inform 7 build 6M62 (I6/v6.33 lib 6/12N) SD

Base of the Tower
Behind the concrete building a steel girder rises from the desert sand, one of three legs of the huge electrical tower looming like some gargantuan spider into blackness above you. A tumbleweed drifts lazily against the rusted metal among scrawny weeds and bits of trash. The desert stretches in all directions except back south towards the building.

Someone left a tin can here years ago: ridged ripples run down its rusty side.

You can also see a broken road sign here.

>TREE
compass (591306) 
  the north
  the northeast
  the northwest
  the south
  the southeast
  the southwest
  the east
  the west
  the up
  the down
  the inside
  the outside
(darkness object) (591338) 
(Inform Parser) (591370) 
(Inform Library) (591402) 
(property_numberspace_forcer) (591434) 
(ValuePropertyHolder_43) (591498) 
(ValuePropertyHolder_47) (591530) 
last day of high school (592714) 
Staying the night (592746) 
canned oranges (592778) 
roll of duct tape (592810) 
gas can (592842) 
Fixing the truck (592874) 
Middle of Nowhere (592906) 
  yourself
    a pack of cigarettes
    a lighter
    a denim jacket (being worn)
  a tall Saguaro
  a worn-out shoe
  an empty water bottle
Crumbling Concrete (593034) 
  some faded graffiti
  a doorway leading inside
Base of the Tower (593130) 
  a tumbleweed
  a rusty tin can
  a broken road sign
  a huge electrical tower
Weed-strewn Rust (593290) 
  some yellowing weeds
Back-tracking (593354) 
Roof (593386) 
Staging Area (593418) 
  a pane of cracked glass
Foreman's Office (593482) 
  a half-collapsed desk
    a rusted key
  a trash bin
    some bits of paper
  a dust-covered window
Break Room (593674) 
  a wire mesh cage (closed)
    an emergency blanket
  a tiny frosted window
Storage Room (593802) 
Tower Vicinity (593834) 
  Around the Tower
  Office Interior

>TREE BREAK ROOM
Break Room (593674) 
  a wire mesh cage (closed)
    an emergency blanket
  a tiny frosted window

>SHOWME TUMBLEWEED
tumbleweed - plant
location: in Base of the Tower
singular-named, improper-named; unlit, inedible, portable; dead
list grouping key: none
printed name: "tumbleweed"
printed plural name: "plants"
indefinite article: none
description: none
initial appearance: none
plant condition: small

>RELATIONS
Suggestion relates various things to one memory:
  The tumbleweed  >=>  the last day of high school
Requirement relates one plan to various things:
  Staying the night  >=>  the canned oranges
  Staying the night  >=>  the emergency blanket
  Fixing the truck  >=>  the roll of duct tape
  Fixing the truck  >=>  the gas can

* * *

>e
You can't go that way.

>n
Crumbling Concrete
You can see some faded graffiti and a doorway leading inside here.

>e
Weed-strewn Rust
You can see some scattered newspapers here.

>x
What do you want to examine?

>look
Weed-strewn Rust
You can see some scattered newspapers here.

* * *

>eat lighter
That's plainly inedible.

* * *

>exit
But you aren't in anything at the moment.

>quit
Are you sure you want to quit?

* * *

>i
You are carrying:
  a pack of cigarettes
  a lighter
  a denim jacket (being worn)

>eat cigarettes
That's plainly inedible.

* * *

>look
Middle of Nowhere
You can see a tall Saguaro, a worn-out shoe and a water bottle (in which are some dust) here.

>look north
You see nothing unexpected in that direction.

>look s
You see nothing unexpected in that direction.

>look e
You see nothing unexpected in that direction.

* * *

>n
Against the Fence
Ahead of you lies a rusty metal fence that stretches for hundreds of meters to the east and west. A faded yellow sign is bolted to the fence.

>inside
Staging Area

>n
Foreman's Office
You can see a half-collapsed desk (on which is a rusted key) and a trash bin (in which are some bits of paper) here.

>take paper
Taken.

>put paper in bin
You put the bits of paper into the trash bin.

* * *

>n
Against the Fence
Ahead of you lies a rusty metal fence that stretches for hundreds of meters to the east and west. A faded yellow sign is bolted to the fence.

>look
Crumbling Concrete

>x
What do you want to examine?

>n
You see nothing unexpected in that direction.

>e
Weed-strewn Rust

>e
You can't go that way.

>w
Crumbling Concrete

>s
Middle of Nowhere
You can see a tall Saguaro, a worn-out shoe and an empty water bottle here.

>n
Crumbling Concrete

>enter
You must supply a noun.

>inside
Staging Area

>look
Staging Area

>x cage
You can't see any such thing.

>e
Break Room
You can see a wire mesh cage (closed) here.

>open cage
You open the wire mesh cage, revealing an emergency blanket.

>take blanket
Taken.

* * *

>n
Against the Fence
Ahead of you lies a rusty metal fence that stretches for hundreds of meters to the east and west. A faded yellow sign is bolted to the fence.

>n
Base of the Tower
Behind the building a steel girder rises from the sand, one of three legs of the huge electrical tower looming like some gargantuan spider into blackness above you. A tumbleweed drifts lazily against the rusted metal among scrawny weeds and bits of trash. The desert stretches in all directions except back south towards the building.

You can see a rusty tin can and a broken road sign here.

>n
Against the Fence
Ahead of you lies a rusty metal fence that stretches for hundreds of meters to the east and west. A faded yellow sign is bolted to the fence

>quit
Are you sure you want to quit?

* * *

>n
Against the Fence
Ahead of you lies a rusty metal fence that stretches for hundreds of meters to the east and west. A faded yellow sign is bolted to the fence

>x
What do you want to examine?

>x sign
You see nothing special about the faded yellow sign.

* * *

>n
Base of the Tower
Behind the building a steel girder rises from the sand, one of three legs of the huge electrical tower looming like some gargantuan spider into blackness above you. A tumbleweed drifts lazily against the rusted metal among scrawny weeds and bits of trash. The desert stretches in all directions except back south towards the building.

You can see a rusty tin can and a broken road sign here.

>pick up towe
You can't see any such thing.

>pick up tower
That's fixed in place.

* * *

>n
Base of the Tower
Behind the building a steel girder rises from the sand, one of three legs of the huge electrical tower looming like some gargantuan spider into blackness above you. A tumbleweed drifts lazily against the rusted metal among scrawny weeds and bits of trash. The desert stretches in all directions except back south towards the building.

You can see a rusty tin can and a broken road sign here.

>x weeds
You see nothing special about the scrawny weeds.

>look
Base of the Tower
Behind the building a steel girder rises from the sand, one of three legs of the huge electrical tower looming like some gargantuan spider into blackness above you. A tumbleweed drifts lazily against the rusted metal among scrawny weeds and bits of trash. The desert stretches in all directions except back south towards the building.

You can see a rusty tin can and a broken road sign here.

* * *

>n
Against the Fence
Ahead of you lies a rusty metal fence that stretches for hundreds of meters to the east and west. A faded yellow sign is bolted to the fence.

>s
Base of the Tower
Behind the concrete building a steel girder rises from the desert sand, one of three legs of the huge electrical tower looming like some gargantuan spider into blackness above you. A tumbleweed drifts lazily against the rusted metal among scrawny weeds and bits of trash. The desert stretches in all directions except back south towards the building.

>e
You can't go that way.

>w
You can't go that way.

>n
Crumbling Concrete
You can see some faded graffiti and a doorway leading inside here.

>n
Base of the Tower
You can see a tumbleweed, a rusty tin can and a broken road sign here.

* * *

>s
Base of the Tower
Behind the concrete building a steel girder rises from the desert sand, one of three legs of the huge electrical tower looming like some gargantuan spider into blackness above you. A tumbleweed drifts lazily against the rusted metal among scrawny weeds and bits of trash. The desert stretches in all directions except back south towards the building.

>s
Crumbling Concrete
This concrete building must've been some sort of utility structure for the huge electrical tower to the north, now abandoned: fragments of glass sparkle faintly in the beam of your headlights. Tendrils of desert sand spill through the empty doorframe leading in to a dark interior; you could also walk around to the east or head south back to your truck.

>e
Weed-strewn Rust
Behind the rather small concrete building is nothing but a scraggly patch of yellowing weeds and dirt near a leaking pipe, littered by a collection of rusted barrels and some scattered newspapers. Desert stretches in all directions; back west is the front of the building.

>w
Crumbling Concrete
This concrete building must've been some sort of utility structure for the huge electrical tower to the north, now abandoned: fragments of glass sparkle faintly in the beam of your headlights. Tendrils of desert sand spill through the empty doorframe leading in to a dark interior; you could also walk around to the east or head south back to your truck.

* * *

>s
Crumbling Concrete
This concrete building must've been some sort of utility structure for the huge electrical tower to the north, now abandoned: fragments of glass sparkle faintly in the beam of your headlights. Tendrils of desert sand spill through the empty doorframe leading in to a dark interior; you could also walk around to the east or head south back to your truck.

>w
You can't go that way.

>e
Weed-strewn Rust
Behind the rather small concrete building is nothing but a scraggly patch of yellowing weeds and dirt near a leaking pipe, littered by a collection of rusted barrels and some scattered newspapers. Desert stretches in all directions; back west is the front of the building.

* * *

>open bottle
You open the water bottle, revealing some dust.

>take dust
Taken.

>put cigarettes in bottle
You put the pack of cigarettes into the water bottle.

>close bottle
You close the water bottle.

>smoke dust
That's not a verb I recognise.

* * *

>pick up Saguaro
That's fixed in place.

>pick up shoe
Taken.

>throw shoe
Dropped.

>look at show
You can't see any such thing.

>look at shoe
You see nothing special about the worn-out shoe.

* * *

>pick up bottle
Taken.

>i
You are carrying:
  a water bottle (open)
    some dust
  a pack of cigarettes
  lighter
  a denim jacket (being worn)

>close bottle
You close the water bottle.

>i
You are carrying:
  a water bottle (closed)
  a pack of cigarettes
  lighter
  a denim jacket (being worn)

>n
Crumbling Concrete
You can see some faded graffiti and a doorway leading inside here.

>go inside
Staging Area
You can see a pane of cracked glass and an overturned bookcase here.

>s
You can't go that way.

>a
That's not a verb I recognise.

>w
You can't go that way.

>e
Break Room
You can see a wire mesh cage (closed) (in which is an emergency blanket), a trash bin (in which are some bits of paper) and a tiny frosted window here.

>w
Staging Area
You can see a pane of cracked glass and an overturned bookcase here.

>n
Foreman's Office
You can see a half-collapsed desk (on which is a rusted key), a dust-covered window and a wastepaper basket (empty) here.

>s
Staging Area
You can see a pane of cracked glass and an overturned bookcase here.

>go outside
Crumbling Concrete
You can see some faded graffiti and a doorway leading inside here.

>go inside
Staging Area
You can see a pane of cracked glass and an overturned bookcase here.

>n
Foreman's Office
You can see a half-collapsed desk (on which is a rusted key), a dust-covered window and a wastepaper basket (empty) here.

>put cigarettes on desk
You put the pack of cigarettes on the half-collapsed desk.

>s
Staging Area
You can see a pane of cracked glass and an overturned bookcase here.

>n
Foreman's Office
You can see a half-collapsed desk (on which are a pack of cigarettes and a rusted key), a dust-covered window and a wastepaper basket (empty) here.

>search desk
On the half-collapsed desk are a pack of cigarettes and a rusted key.

>search bin
You can't see any such thing.

>search basket
The wastepaper basket is empty.

>e
You can't go that way.

>n
You can't go that way.

>s
Staging Area
You can see a pane of cracked glass and an overturned bookcase here.

>e
Break Room
You can see a wire mesh cage (closed) (in which is an emergency blanket), a trash bin (in which are some bits of paper) and a tiny frosted window here.

>open cage
You open the wire mesh cage.

>close cage
You close the wire mesh cage.

>take blanket
The wire mesh cage isn't open.

>open cage
You open the wire mesh cage.

>take blanket
Taken.

>x
What do you want to examine?

>look
Break Room
You can see a wire mesh cage (empty), a trash bin (in which are some bits of paper) and a tiny frosted window here.

>close window
It isn't something you can close.

>s
You can't go that way.

>w
Staging Area
You can see a pane of cracked glass and an overturned bookcase here.

>enter bookcase
You get onto the overturned bookcase.

>exit bookcase
I only understood you as far as wanting to exit.

>get off bookcase
You get off the overturned bookcase.

Staging Area
You can see a pane of cracked glass and an overturned bookcase here.

>n
Foreman's Office
You can see a half-collapsed desk (on which are a pack of cigarettes and a rusted key), a dust-covered window and a wastepaper basket (empty) here.

>get on desk
That's not something you can enter.

* * *

>quit
Are you sure you want to quit?

* * *

>s
Crumbling Concrete
The building is nondescript. The windows include the pane of cracked glass, the dust-covered window and the tiny frosted window.

You can see some faded graffiti and a doorway leading inside here.

>s
Middle of Nowhere
The tire tracks from the south stop abruptly here, but where the hell are you? The desert sand and clumps of pale sagebrush are all your dimming headlights pick out before barely reaching a concrete building to the north.

You can see a pickup truck (closed and empty), a tall Saguaro, a worn-out shoe and a water bottle (in which are some dust) here.

* * *

>x
What do you want to examine?

>look
Middle of Nowhere

>n
Crumbling Concrete