week7
An Interactive Fiction by Matthew Deline
Release 1 / Serial number 180308 / Inform 7 build 6M62 (I6/v6.33 lib 6/12N) SD

New Cross Road

>e
New Cross Station
You can see some snowshoes here.

>pick up shoes
You can't see any such thing.

>pick up snowshoes
Taken.

>wear snowshoes
You put on the snowshoes.

>w
New Cross Road

>s
Laurie Grove
You can see a BPB door here.

>n
New Cross Road

>s
Laurie Grove
You can see a BPB door here.

>rules
Rules tracing now switched on. Type "rules off" to switch it off again, or "rules all" to include even rules which do not apply.

>unlock door
What do you want to unlock the BPB door with?

>unlock door with keycard
[Rule "declare everything initially unmentioned rule" applies.]
[Rule "announce items from multiple object lists rule" applies.]
[Rule "set pronouns from items from multiple object lists rule" applies.]
[Rule "before stage rule" applies.]
[Rule "instead stage rule" applies.]
[Rule "Instead of unlocking the BPB door with the keycard" applies.]
[Rule "announce items from multiple object lists rule" applies.]
[Rule "set pronouns from items from multiple object lists rule" applies.]
[Rule "before stage rule" applies.]
[Rule "instead stage rule" applies.]
[Rule "investigate player's awareness before action rule" applies.]
[Rule "player aware of his own actions rule" applies.]
[Rule "check stage rule" applies.]
[Rule "carry out stage rule" applies.]
[Rule "carry out keycard swiping rule" applies.]
[Rule "after stage rule" applies.]
[Rule "investigate player's awareness after action rule" applies.]
[Rule "report stage rule" applies.]
[Rule "report keycard swiping rule" applies.]
The BPB doors unlock. The automatic opening mechanism looks non-functional today. Maybe it's too cold?
[Rule "last specific action-processing rule" applies.]

[Rule "A first turn sequence rule" applies.]
[Rule "every turn stage rule" applies.]
[Rule "have we got into the GDS rule" applies.]
[Rule "broken leg rule" applies.]
[Rule "A last turn sequence rule" applies.]
[Rule "notify score changes rule" applies.]

* * *

>e
New Cross Station
You can see some snowshoes here.

>wear shoes
You can't see any such thing.

>wear snowshoes
(first taking the snowshoes)
You put on the snowshoes.

>i
You are carrying:
  some snowshoes (being worn)

* * *

>e
New Cross Station
You can see some snowshoes here.

>wear snowshoes
(first taking the snowshoes)
You put on the snowshoes.

>w
New Cross Road

* * *

>s
Laurie Grove
You can see a BPB door here.

>x door
You see nothing special about the BPB door.

* * *

week7
An Interactive Fiction by Matthew Deline
Release 1 / Serial number 180308 / Inform 7 build 6M62 (I6/v6.33 lib 6/12N) SD

New Cross Road

>n
You can't go that way.

>w
as you head off, you slip on the ground.

* * *

week7
An Interactive Fiction by Matthew Deline
Release 1 / Serial number 180308 / Inform 7 build 6M62 (I6/v6.33 lib 6/12N) SD

New Cross Road

>s
Laurie Grove
You can see a BPB door here.

>n
as you head off, you slip on the ground.

>n
as you head off, you slip on the ground.

>n
New Cross Road

* * *

>n
as you head off, you slip on the ground.

>n
as you head off, you slip on the ground.

    *** Oh no! You have broken your leg. ***

Would you like to RESTART, RESTORE a saved game, QUIT or UNDO the last command?

>restart
week7
An Interactive Fiction by Matthew Deline
Release 1 / Serial number 180308 / Inform 7 build 6M62 (I6/v6.33 lib 6/12N) SD

New Cross Road

* * *

>n
as you head off, you slip on the ground.

>s
Laurie Grove

>n
as you head off, you slip on the ground.

* * *

>n
as you head off, you slip on the ground.

    *** Oh no! You have broken your leg. ***

Would you like to RESTART, RESTORE a saved game, QUIT or UNDO the last command?

>restart
week7
An Interactive Fiction by Matthew Deline
Release 1 / Serial number 180302 / Inform 7 build 6M62 (I6/v6.33 lib 6/12N) SD

New Cross Road

>e
New Cross Station
You can see some snowshoes here.

* * *

>w
New Cross Road

>s
Laurie Grove

>n
New Cross Road

>sn
That's not a verb I recognise.

>s
Laurie Grove

* * *

>n
New Cross Road

>s
Laurie Grove

* * *

>n
New Cross Road

>quit
Are you sure you want to quit?

* * *

>n
as you head off, you slip on the ground.

>s
You can't go that way.

>n
as you head off, you slip on the ground.

    *** Oh no! You have broken your leg. ***

Would you like to RESTART, RESTORE a saved game, QUIT or UNDO the last command?

* * *

>s
Laurie Grove

>w
GDS

    *** Hooray! You have reached your destination. ***

Would you like to RESTART, RESTORE a saved game, QUIT or UNDO the last command?

>restart
week7
An Interactive Fiction by Matthew Deline
Release 1 / Serial number 180302 / Inform 7 build 6M62 (I6/v6.33 lib 6/12N) SD

New Cross Road

>s
Laurie Grove

>b
That's not a verb I recognise.

>n
New Cross Road

>rules
Rules tracing now switched on. Type "rules off" to switch it off again, or "rules all" to include even rules which do not apply.

* * *

>n
as you head off, you slip on the ground.

>w
as you head off, you slip on the ground.

>s
as you head off, you slip on the ground.

>s
as you head off, you slip on the ground.

>s
as you head off, you slip on the ground.

    *** Oh no! You have broken your leg. ***

Would you like to RESTART, RESTORE a saved game, QUIT or UNDO the last command?

* * *

>s
Laurie Grove
You can see a BPB door here.

>s
as you head off, you slip on the ground.

>s
Laurie Grove

>s
You can't go that way.

>w
GDS

    *** Hooray! You have reached your destination. ***

Would you like to RESTART, RESTORE a saved game, QUIT or UNDO the last command?

* * *

>swipe keycard in card reader
The BPB doors unlock. The automatic opening mechanism looks non-functional today. Maybe it's too cold?

* * *

>s
Laurie Grove
You can see a BPB door here.

>unlock card reader
(with the keycard)
That doesn't seem to be something you can unlock.

* * *

>s
Laurie Grove
You can see a BPB door here.

>unlock door
(with the keycard)
The BPB doors unlock. The automatic opening mechanism looks non-functional today. Maybe it's too cold?

* * *

>s
Laurie Grove
You can see a BPB door here.

>w
(first opening the BPB door)
It seems to be locked.

* * *

>w
(first opening the BPB door)
It seems to be locked.

* * *

week7
An Interactive Fiction by Matthew Deline
Release 1 / Serial number 180308 / Inform 7 build 6M62 (I6/v6.33 lib 6/12N) SD

New Cross Road

>w
New Cross Gate

>rules
Rules tracing now switched on. Type "rules off" to switch it off again, or "rules all" to include even rules which do not apply.

>s
[Rule "declare everything initially unmentioned rule" applies.]
[Rule "standard set going variables rule" applies.]
[Rule "announce items from multiple object lists rule" applies.]
[Rule "set pronouns from items from multiple object lists rule" applies.]
[Rule "before stage rule" applies.]
[Rule "instead stage rule" applies.]
[Rule "investigate player's awareness before action rule" applies.]
[Rule "player aware of his own actions rule" applies.]
[Rule "check stage rule" applies.]
[Rule "can't travel in what's not a vehicle rule" applies.]
[Rule "can't go through undescribed doors rule" applies.]
[Rule "can't go through closed doors rule" applies.]
[Rule "determine map connection rule" applies.]
[Rule "can't go that way rule" applies.]
You can't go that way.

[Rule "A first turn sequence rule" applies.]
[Rule "every turn stage rule" applies.]
[Rule "have we got into the GDS rule" applies.]
[Rule "broken leg rule" applies.]
[Rule "A last turn sequence rule" applies.]
[Rule "notify score changes rule" applies.]